################
#______________#
#___________H__#
#___H__________D
#______________#
#_____H____H___#
#______________#
#________H_____#
#______________#
#____A____H____#
#______________#
################
