################
#_#___#________#
#_#_#_#_######_#
#_#_#_#_#______#
#_#_#_#_#_######
#___#_#_#_#___D#
#####_#_#___#_##
#_____#_#####_##
#_#####_#_____##
#_#___#_#_######
#___#___#_____A#
################
