#________________________________________________________________________
#________________________________________________________________________
#________________________________________________________________________
#________________________________________________________________________
#_________________________________________________########_______________
#_____________________########___________________________________________
#________________________________________________________________________
#__________________________________________________________#####_________
#_____________#######________________#############_______________________
#__#__________________________________________________________#######____
D___A________#___________________________________________________________
#########################################################################

