0________________________________________________________________________
0________________________________________________________________________
0________________________________________________________________________
0________________________________________________________________________
0_________________________________________________########_______________
0_____________________########___________________________________________
0________________________________________________________________________
0__________________________________________________________#####_________
0_____________#######________________#############_______________________
#____#________________________________________________________#######____
D___A______#_____________________________________________________________
########H###H############################################################

