0________________________________________________________________________
0________________________________________________________________________
0________________________________________________________________________
0________________________________________________________________________
0_________________________________________________########_______________
0_____________________########___________________________________________
0________________________________________________________________________
0__________________________________________________________#####_________
0_____________#######________________#############_______________________
#__#__________________________________________________________#######____
D___A________#___________________________________________________________
#########################################################################

