################
#              #
#  #           #
#              #
#              #
#   ###        #
#      ##      #
#              #
#      ###     #
#   ###        #
#        ##    #
################
